OK n218 -> laguiole
griff tanen -> tuyau ?
Kick-Ass -> Masse de combat verte
Mokla -> Baton noir
Kelesis -> Voir nom des épée dans le jeu
Link -> Épée de légende
OK Ho-Dae-soo -> marteau leger ? (voir pst ou iwd2)
Canigou & Barnabé Bonarien et Vlad et toutes les armes de loup-garou-> Icône morsure
OK Pile ou face -> épée sainte + épée démoniaque
Shino -> toucher drainant la magie
OK Tukaram -> Voir nom des épées dans le jeu
Gilius Thunderhead et Sixte averoes et Muradin barbe de bronze-> hache à deux tranchants (iwd)
Shale -> poing de pierre (icone ishape03)
Lloyd Irving -> Spéciales ?
OK Gar -> Hache pyrotechnique
OK Pip -> E.J. épée longue +5
OK Negan -> Lucile
OK Murtagh -> zar'roc
Dogi -> poing d'acier ou poing avec des piques (PST ? si oui, ajouter 1D3 perçant à sa frappe)
Cavendish -> fleuret
OK irito : Elucidator + Dark Repulser (pas besoin d'icone pour Dark repulser (pxl2kir2) et voir si icone de Elucidator pas deja dans Todd et commune avec Akame)
Benjamin Grim -> poing = dague, recoloré (icone ishape06 recolorée)
Requiem -> Épée machintruc
OK Torquemada : icone ishape05 OK et aussi sur amulette du loup
Vlad von kasten -> bâtarde voleuse de vie "Buveuse de sang" & Morsure vampirique (icône morsure)
Shiba tsukune -> katana de feu Ofushikai
OK Ryu Hayabusa -> l'épée du dragon OK
Reine Geleeda la blanche ->Dame de la Vallée (Relique et ritual p159) -> special autoriséer aux mages.
Immothep & Tutt-ut -> donner une icône a leur armes
Thusa doom -> donner une icône a son arme (liche, utiliser celle de zagor)
OK Akame -> katana noir Murasame OK (même icone que Elucidator ???????, déjà dans Todd ?)
OK Kenshiro -> poing tueur
Kratos ????
Zagor -> 2 armes spéciales, liche + démon
tyrael -> corriger bug icône
Falgant -> Rebeck qui tire des rayons
Baron Zasharck -> Épée bâtarde +5 qui a 6% de chance (chacun) de faire poison/maladie (dégats)/immobilisation/peur